WWWWWWWWWWWWWWWWWWWWWWWWWWWWWW
WSSSSSSSSSSPSSSBSSSSSSSSSSSSSW
WSWWWWWWWWWWSWWWWSWWWWWWWWWWSW
WSWBSSSSSSSSSSSSSSSSSSSSSSBWSW
WSWSWWWWWWWWWSWWSWWWWWWWWWSWSW
WSWSSSSSSSSSSSS2SSSSSSSSSSSWSW
WSWSWWWWWWWWWWSSWWWWWWWWWWSWSW
WSWSWSSSSSSSSSSSSSSSSSSSSWSWSW
WSWSWSWWWWWWWWSSWWWWWWWWSWSWSW
WSWSSSWBSSSSSSSSSSSSSSBWSSSWSW
WSBSWSSSSSSSSS1SSSSSSSSSSWSBSW
WSWSWSSSSSSSSSSSSSSSSSSSSWSWSW
WSWSSSWBSSSSSSSSSSSSSSBWSSSWSW
WSWSWSWWWWWWWWSSWWWWWWWWSWSWSW
WSWSWSSSSSSSSSSSSSSSSSSSSWSWSW
WSWSWWWWWWWWWWSSWWWWWWWWWWSWSW
WSWBSSSSSSSSSSSSSSSSSSSSSSBWSW
WSWWWWWWWWWWSSWWSSWWWWWWWWWWSW
WSSSSSSSSSSSSSBSSSSSSSSSSSSSSW
WWWWWWWWWWWWWWWWWWWWWWWWWWWWWW